1111111111
1000000001
1000000001
1000000001
1000000001
1000000001
1000000001
1000000001
1000000001
1000000001
101000$001
1010000001
1010000001
1010000001
1111111111